Evento	        Descripción
error	        Ocurre cuando se produce un error.
wheel	        Se dispara al girar la rueda del ratón.
focus	        Se activa cuando un elemento obtiene el foco.
drag	        Se activa durante la acción de arrastrar.
reset	        Ocurre al restablecer un formulario.
submit	        Se dispara al enviar un formulario.
scroll      	Ocurre al desplazarse por el contenido.
change      	Se activa cuando cambia el valor de un elemento.
blur	        Ocurre cuando un elemento pierde el foco.
abort	        Se dispara en la cancelación de una descarga.
paste	        Ocurre al pegar contenido en un elemento.
cut	            Se activa al cortar contenido de un elemento.
select	        Ocurre al seleccionar texto en un elemento.
contextMenu	    Se dispara al abrir el menú contextual.
copy	        Ocurre al copiar contenido de un elemento.
pointerMenu	    Se dispara al abrir el menú del puntero.
keyDown	        Se activa al presionar una tecla.
keyUp	        Ocurre al soltar una tecla.
Mouse (move)	Ocurre al mover el ratón sobre un elemento.
Mouse (out)	    Se activa cuando el ratón sale de un elemento.
Mouse (down)	Ocurre al presionar el botón del ratón.
Mouse (up)	    Se dispara al soltar el botón del ratón.
Mouse (leave)	Ocurre al abandonar el área de un elemento.
Mouse (enter)	Se activa al ingresar al área de un elemento.

Cuando toco el nodo, si lo que quiero es coger su contenido(será practicamente siempre), recuerda que debo despues de llamar al child coger el VALUE, también recuerda de coger el indice de ese nodo. 
                    ###PRO TIP: Si veo en plurales, casi siempre serán arrays###
    ejemplo: 
    document.getElementById("id02").innerHTML = document.getElementById("id01").firstChild.nodeValue;
    var txt = document.getElementById("id01").childNodes[0].nodeValue;
    document.write(txt);

Si por otro lado queremos la etiqueta(el nodo en ese caso, es como lo llamamos), utilizaremos "nodeName".
Por último, si queremos el atributo, usaremos "getAttribute" o simplemente "attr", pero no todos los nodos tienen atributos, así que hay que verificarlo antes.
